30 13
150 1475
1 1 1 1 1 1 1 1 1 1 1 1 1 1 1 1 1 1 1 1 1 1 1 1 1 1 1 1 1 1 
1 0 0 0 0 0 0 0 0 0 0 0 0 0 0 0 0 0 0 0 0 0 0 0 0 0 0 0 0 1 
1 0 0 0 0 0 0 0 0 0 0 2 3 3 3 3 4 0 6 0 0 0 0 0 0 0 6 0 2 4
1 0 0 0 0 0 0 0 0 6 0 0 0 0 0 0 0 0 0 0 0 0 0 0 6 0 0 0 0 1 
1 0 0 0 0 0 0 6 0 0 0 0 0 0 0 0 0 0 0 0 5 7 0 0 0 0 6 0 0 1
1 0 0 5 6 7 0 0 0 0 0 0 0 0 0 0 0 0 0 0 0 0 0 0 0 0 0 0 6 1
2 4 0 0 0 0 0 0 0 2 3 3 3 3 3 3 3 4 0 0 0 0 6 0 6 0 6 0 0 1
2 3 3 3 4 0 5 7 0 0 0 0 0 0 0 0 0 0 0 6 0 0 0 0 0 0 0 0 0 1
1 0 0 0 0 0 0 0 0 0 0 0 0 0 0 0 0 6 0 0 0 0 0 0 0 0 0 0 0 1
1 0 0 0 0 0 0 0 0 0 0 0 0 0 0 0 0 0 0 5 7 0 6 0 6 0 0 0 0 1 
1 0 0 0 0 0 0 0 0 0 0 0 2 3 4 0 0 0 0 0 0 0 0 0 0 0 6 0 0 1 
12 0 0 0 0 0 5 7 0 5 7 0 0 0 0 0 0 0 0 0 0 0 0 0 0 0 0 0 2 4 
2 3 3 3 4 8 8 8 8 8 8 8 8 8 8 8 2 4 8 3 8 3 8 3 8 2 3 3 10 11 