30 13
150 1475
1 1 1 1 1 1 1 1 1 1 1 1 1 1 1 1 1 1 1 1 1 1 1 1 1 1 1 1 1 1 
1 0 0 0 0 0 0 0 0 0 0 16 0 16 0 16 0 0 0 0 0 0 0 0 0 0 0 0 0 14 
1 0 0 0 0 0 0 0 0 0 0 2 3 3 3 3 4 0 6 0 0 0 0 0 0 0 6 0 2 4
1 0 0 0 0 0 0 0 0 6 0 0 0 0 0 0 0 0 0 0 0 0 0 0 6 0 0 0 0 1 
1 0 0 0 16 0 0 6 0 0 0 0 0 0 0 0 0 0 0 0 5 7 0 0 0 0 6 0 0 1
13 0 0 5 6 7 0 0 0 0 14 0 16 0 16 0 14 0 0 0 0 0 0 0 0 0 0 0 6 1
13 13 0 16 16 0 0 0 0 2 3 3 3 3 3 3 3 4 0 0 0 0 6 0 6 0 6 0 0 1
2 3 3 3 4 0 5 7 0 0 0 0 0 0 0 0 0 0 0 6 0 0 0 0 0 0 0 0 0 1
1 0 0 0 0 0 0 0 0 0 0 0 0 0 0 0 0 6 0 0 0 0 0 0 0 0 0 0 0 1
1 0 0 0 0 0 0 0 0 0 0 0 16 16 16 0 0 0 0 5 7 0 6 0 6 0 0 0 0 1 
13 0 0 0 0 0 0 0 0 0 0 0 2 3 4 0 0 0 0 0 0 0 0 0 0 0 6 0 0 13 
13 0 16 16 0 0 5 7 0 5 7 0 0 0 0 0 0 0 0 16 0 0 0 16 0 0 16 0 13 13 
2 3 3 3 4 8 8 8 8 8 8 8 8 8 8 8 2 4 8 3 8 3 8 3 8 2 3 3 3 4 