8 5
100 100 
0 0 0 0 0 0 0 0
5 7 0 0 0 0 5 7
0 0 0 2 4 0 0 0
0 0 5 6 6 7 0 0
7 8 8 8 8 8 8 5
