10 6
100 450
1 1 1 1 1 1 1 1 1 1 
1 0 0 0 0 0 0 0 0 1
1 0 0 0 0 0 5 6 7 1
1 0 0 0 5 7 0 0 0 1
1 0 2 0 0 0 0 3 0 1
2 3 3 3 3 3 3 3 3 4
